11111111111111111111111111
10000000000110000001000001
1111000000C000000000000001
1CC00000000000000110000001
10000000000000000000000001
100000000000000E00000I0001
100000P0000000000000000001
10000000000000110000000001
11111111111111111111111111
