111111111111111111111111111111111111111111111111111111111111111111111111
10000000000000000000000000000000000C000000000000000000000000000000000001
100000000000000000000000000000000000000000000000000000000000000000000001
100000000000000000000000000000000000000000000000000000000000000000000001
100000000011111000000I000000000000C0C0000000000I000000111110000000000001
100000000011111000000000000000000000000000000000000000111110000000000001
100000000011111000000000000000000000000000000000000000111110000000000001
100000000000000000000000000000000000000000000000000000000000000000000001
100000000000C0000000000000000000000E00000000000000000000C000000000000001
1C0000000000C0000000000000000000000000000000000000000000C0000000000000C1
100000000000000000000000000000000000000000000000000000000000000000000001
100000000011111000000000000000000000000000000000000000111110000000000001
100000000011111000000000000000000000000000000000000000111110000000000001
100000000011111000000I000000000000C0C0000000000I000000111110000000000001
100000000000000000000000000000000000000000000000000000000000000000000001
10000P000000000000000000000000000000000000000000000000000000000000000001
10000000000000000000000000000000000C000000000000000000000000000000000001
111111111111111111111111111111111111111111111111111111111111111111111111
