11111111111
10000000001
10000000001
10000010001
11111111111
