111111111111111
10000C000000C01
100000000000001
1P0000100E00001
111111111111111
