1111111111
1PEC111111
1111111111
